"filename", "language", "Python", "Markdown", "comment", "blank", "total"
"d:\Projects\2022RogueLikeTutorial\README.md", "Markdown", 0, 3, 0, 3, 6
"d:\Projects\2022RogueLikeTutorial\actions.py", "Python", 105, 0, 18, 35, 158
"d:\Projects\2022RogueLikeTutorial\color.py", "Python", 14, 0, 0, 5, 19
"d:\Projects\2022RogueLikeTutorial\components\__init__.py", "Python", 0, 0, 0, 1, 1
"d:\Projects\2022RogueLikeTutorial\components\ai.py", "Python", 39, 0, 13, 19, 71
"d:\Projects\2022RogueLikeTutorial\components\base_component.py", "Python", 14, 0, 0, 6, 20
"d:\Projects\2022RogueLikeTutorial\components\consumable.py", "Python", 34, 0, 6, 11, 51
"d:\Projects\2022RogueLikeTutorial\components\fighter.py", "Python", 49, 0, 0, 18, 67
"d:\Projects\2022RogueLikeTutorial\components\inventory.py", "Python", 14, 0, 3, 8, 25
"d:\Projects\2022RogueLikeTutorial\components\testFighter.py", "Python", 49, 0, 0, 18, 67
"d:\Projects\2022RogueLikeTutorial\engine.py", "Python", 43, 0, 2, 12, 57
"d:\Projects\2022RogueLikeTutorial\entity.py", "Python", 108, 0, 8, 22, 138
"d:\Projects\2022RogueLikeTutorial\entity_factories.py", "Python", 35, 0, 0, 2, 37
"d:\Projects\2022RogueLikeTutorial\exceptions.py", "Python", 1, 0, 4, 1, 6
"d:\Projects\2022RogueLikeTutorial\game_map.py", "Python", 56, 0, 10, 16, 82
"d:\Projects\2022RogueLikeTutorial\input_handlers.py", "Python", 210, 0, 36, 55, 301
"d:\Projects\2022RogueLikeTutorial\main.py", "Python", 57, 0, 2, 15, 74
"d:\Projects\2022RogueLikeTutorial\message_log.py", "Python", 51, 0, 15, 13, 79
"d:\Projects\2022RogueLikeTutorial\procgen.py", "Python", 91, 0, 14, 28, 133
"d:\Projects\2022RogueLikeTutorial\render_functions.py", "Python", 34, 0, 0, 13, 47
"d:\Projects\2022RogueLikeTutorial\render_order.py", "Python", 5, 0, 0, 2, 7
"d:\Projects\2022RogueLikeTutorial\testActions.py", "Python", 105, 0, 18, 43, 166
"d:\Projects\2022RogueLikeTutorial\testInputHandlers.py", "Python", 257, 0, 45, 79, 381
"d:\Projects\2022RogueLikeTutorial\tile_types.py", "Python", 38, 0, 4, 7, 49
"Total", "-", 1409, 3, 198, 432, 2042